...........
.#......#..
.##....##..
.#.#..#.#..
.#..##..#..
.#......#..
.#......#..
.#......#..
.#......#..
.#......#..
...........