...........
.#......#..
.#......#..
.#..#...#..
.#...#..#..
.#...#..#..
.#...#..#..
.#....#.#..
.#......#..
.#......#..
....#####..