#####.#####
#.........#
#.#######.#
#.#...#.#.#
#.#.###.#.#
###.......#
#...###.#.#
#.###.#.#.#
#.#...###.#
#...#...#.#
#####.#####