.#.#.#.#.#.
#..#..#..#.
...#...#...
#....#....#
....##.....
.#......#..
.#......#..
.#......#..
.#......#..
.#......#..
...........